W W W W W W W W W W W W W W W W 
W P B - W W E - - W W - - - - W
W - - - W W B B - W W - - - - W
W - B B - - - B - - - - - - - W
W - - D D D B - - - - - - - - W
W - - - - - - B - - - - - - - W
W - - - - - - - - - - - - - - W
W - B - W W - - - W W - - - - W
W - - - W W - - - W W - - - - W
W W W W W W W W W W W W W W W W 