W W W W W W W W W W W W W W W W 
W P B M W W M M D W W M M M M W
W M M M W W B M M W W M M D M W
W M M B M M M M M B M M D M M W
W M M M D D B M D M M M M B M W
W M M M M D M B M M B M D M D W
W M B M W W M M D W W B D M M W
W M M M W W M M M W W M M M E W
W W W W W W W W W W W W W W W W 