W W W W W W W W W W W W W W W W 
W P B M W W M D M W W M M M M W
W M M M W W B B M W W M M B M W
W M B B M M D B M B B M M D M W
W D M B D B B B M M M B M B M W
W M M M M M M B M M B M M M M W
W M B M D W M D D W W B D M M W
W M M M W W M E M W W M M M M W
W W W W W W W W W W W W W W W W 