W W W W W W W W W W W W W W W W 
W P M B W W M M M W W M M M M W
W D M M W W B M M W W M M B M W
W M M M M M M B M B B M M D M W
W D M M M D D D D M M M M B M W
W M M M M M M B M M B M M M M W
W M B M W W M M M W W B D M M W
W M M M W W M M M W W M M M E W
W W W W W W W W W W W W W W W W 