W W W W W W W W W W W W W W W W 
W P B M W W M M M W W M M M M W
W M M M W W B M M W W M M B M W
W M B B M M B B M B B M D D M W
W M M D D D M M M M M M M B M W
W M M D M M M M D W B B M M M W
W M B M D W M M D W W B D M M W
W M M M W W M D M W W M M E M W
W W W W W W W W W W W W W W W W 