W W W W W W W W W W W W W W W W 
W P - B W W - - - W W - - - - W
W D - - W W B - - W W - - B - W
W - - - - - - B - B B - - D - W
W D - - - D D D D - - - - B - W
W - - - - - - B - - B - - - - W
W - B - W W - - - W W B D - - W
W - - - W W - - - W W - - - E W
W W W W W W W W W W W W W W W W 